SO ./textures/south.xpm
WE ./textures/west.xpm
EA ./textures/east.xpm
F 100,150,200
C 50,50,50

111111
100001
1000N1
100001
111111
