NO ./textures/north.xpm
SO ./textures/south.xpm
WE ./textures/west.xpm
EA ./textures/east.xpm
F 100,150,200
C 50,50,50

111111
1N0001
1000S1
100001
111111
